3 13 31
###############################
#p   ** **    *  1      3     #
# # # #*# # # # # # # # # # # #
#*     ** * *  *   * ** 3 f   #
# # # # # #*# # # # # # #*# # #
#*   *s*    *** * x **  2     #
# # # # # # # # # # # # # #*# #
#    l   3 * b   4  *  1 **  1#
# #*# # #*#*#*#*# # #1# # #*# #
#   4  1 *   *2*    *   *     #
#*# # # # # # # # # # #*# # #*#
# *  2 * **    ** ***     1   #
###############################



Items:
b - Bomb Item
f - Flame Item
s - Speed Item
l - Live Item