2 13 31
###############################
#p * *3       *  ** * * 2    *#
# # # # #s# # #*# # # # # #*# #
#    * * *** **1  b  *    **  #
# #*# # # # # # #b#1# # # # #*#
#     3    b     **  3   s  **#
#b# #*# # # # # #*#*#*#*# # # #
#   *  1  f  *   * *x* *      #
# # # # #*# # # # # # #*# #f# #
#   ***l     3   *       2    #
# # # # # # # # # #*# # # # #*#
#1 ** *   *    3     1   1    #
###############################



Items:
b - Bomb Item
f - Flame Item
s - Speed Item
l - Live Item