1 13 31
###############################
#p         l   l   l          #
# # # # # # # # # # # # # # # #
#          f   f   f          #
# # # # # # # # # # # # #1# # #
#          b   b   b   3      #
# # # # # # # # # # # # # # # #
#          s   s   s          #
# # # # # # # # # # # # # # # #
#                 x           #
# # # # # # # # # # # # # # # #
#                         4   #
###############################
